111111111111
100P00000C01
100000010001
100C00000E01
100000000001
111111111111
