1111111111111111111111
100000000000P001C10001
100CCCC000000001011001
100000000000E000000001
1100000000C00000000001
1111111111111111111111
