1111111111111
1E01000000001
10C0000000001
1P000C0000001
1111111111111
