111111111
1CC0E01C1
100P00011
111111111
