11111
1E0P1
10001
1C0C1
11111
