1111111111111111111111
100000000000P000000001
100CCCC000000000001001
100000000000E000000001
1100000000C00000000001
1111111111111111111111
