1111111111111111111111111111111111111111
1111111111111111111111111000000000000001
1P000000000000000000000000000C00000001E1
1111111111111111111111111000000000000001
1111111111111111111111111000000000000001
1111111111111111111111111000000000000001
1111111111111111111111111000000000000001
1111111111111111111111111000000000000001
1111111111111111111111111000000000000001
1111111111111111111111111000000000000001
1111111111111111111111111000000000000001
1111111111111111111111111000000000000001
1111111111111111111111111000000000000001
1111111111111111111111111000000000000001
1111111111111111111111111000000000000001
1111111111111111111111111000000000000001
1111111111111111111111111000000000000001
1111111111111111111111111111111111111111
