11111111111111111
1000000P000C11C11
10000000000001011
100E0000C00000001
100000C0001000001
11111111111111111
